filename, language, Python, TeX, Perl, comment, blank, total
__init__.py, Python, 0, 0, 0, 2, 1, 3
__main__.py, Python, 111, 0, 0, 58, 13, 182
pdf\rivet_pdf.sty, TeX, 0, 46, 0, 11, 1, 58
rivet_chk.py, Python, 39, 0, 0, 27, 22, 88
rivet_lib.py, Python, 179, 0, 0, 97, 48, 324
rivet_reprt.py, Python, 137, 0, 0, 50, 23, 210
rivet_rst.py, Python, 675, 0, 0, 231, 42, 948
rivet_unit.py, Python, 77, 0, 0, 12, 8, 97
rivet_utf.py, Python, 429, 0, 0, 134, 49, 612
table\tabulate.py, Python, 835, 0, 0, 550, 156, 1541
tex\tex2uni.pl, Perl, 0, 0, 2076, 240, 424, 2740
unum\__init__.py, Python, 320, 0, 0, 131, 74, 525
unum\units\__init__.py, Python, 2, 0, 0, 1, 2, 5
unum\units\custom\__init__.py, Python, 4, 0, 0, 11, 8, 23
unum\units\others\__init__.py, Python, 31, 0, 0, 7, 3, 41
unum\units\si\__init__.py, Python, 1, 0, 0, 1, 2, 4
unum\units\si\base.py, Python, 150, 0, 0, 7, 16, 173
unum\units\si\derived.py, Python, 27, 0, 0, 6, 4, 37
Total, -, 3017, 46, 2076, 1576, 896, 7611